Exposure to violent video games causes at least a temporary increase in aggression and this exposure correlates with aggression in the real world	neg
video game violence is not related to serious aggressive behavior in real life	pos
some violent video games may actually have a prosocial effect in some contexts	pos
exposure to violent video games causes both short term and long term aggression in players and decreases empathy and prosocial behavior	neg
Violent video games increase the violent tendencies among youth	neg
No conclusive link was found between video game usage and violent activity	pos
violent video games are significantly associated with: increased aggressive behavior, thoughts, and affect; increased physiological arousal; and decreased pro-social (helping) behavior	neg
video game publishers unethically train children in the use of weapons and, more importantly, harden them emotionally to the act of murder	neg
violent video games may increase mild forms of aggressive behavior in children and young adults	neg
exposure to violent video games results in increased physiological arousal, aggression-related thoughts and feelings as well as decreased prosocial behavior	neg
No long-term relationship was found between playing violent video game and youth violence or bullying	pos
No evidence has found that violent games are psychologically harmful to minors	pos
adolescents that don't play video games at all are most at-risk for violent behavior	neg
video game play is part of an adolescent boy's normal social setting	pos
Biological theories of aggression and violence have specifically excluded video game and other media effects	pos
Reinforcement of sexist stereotypes has been claimed as an effect of violent video games	neg
A correlation was found between children playing violent video games and suffering psychological effects	neg
violent video games can increase children's aggression	neg
Media influences are too weak and distant to have much influence on aggressiveness	pos
violent video games promote violent behavior, attitudes and beliefs by desensitizing an individual to aggression	neg
Excessive exposure to violent video games and other violent media has been linked to aggressive behaviour	neg
Neurological link was found between playing violent video games and aggressive behaviour in children and teenagers	neg
There is no direct link between violent video games and their influence on children	pos
Video games develop the individual's intelligence	pos
violent games help students deal with stress and aggression	pos
violent games affect students positively and not negatively	pos
many skills can be learned from the gaming experience, it builds practical and intellectual skills	pos
media cannot cause violence because humans have the ability to recognize what is wrong, and what is right	pos
video games have many healthy and positive aspects	pos
Video games can be a safe outlet for aggression and frustration	pos
Violent video games are influencing children's view about violence	neg
Various games are accused of causing addiction and even violent behavior	neg
exposure to graphic violence leads to desensitization to committing acts of violence in person	neg
violence in games hardens children to unethical acts	neg
children may imitate aggressive behaviors witnessed in media	neg
societal media consumption and violent crime rates are not well associated	pos
media violence may increase aggression	neg
Violent video games - especially first-person shooter games - encourages real-life acts of violence in teenagers	neg
video games allow children to act out crimes	neg
violence in video games is not causally linked with aggressive tendencies	pos
Correlations between violent gameplay and some comming childhood problems were found	neg
most children who play violent games do not have problems	pos
Many creative, social and emotional benefits from video game play have been documented - even games with violent content	pos
Not all depictions of violence are bad to witness	pos
There is no connection between exposure to media violence and real life violence	pos
heavy exposure to media violence can lead to more aggressive behavior	neg
Exposure alone to media violence does not cause a child to commit crimes	pos
there is no convincing evidence that prove that media violence cause violent crime or any type of real life violence	pos
Exposure to violent video games[REF] is related to increased aggressiveness in children	neg
numerous researchers have proposed potential positive effects of video games	pos
computer games cause violence	neg
A correlation between violent content conveyed through media (including videogames) and violent or aggressive behavior has been shown	neg
Some serious psychological problems have been attributed to desensitization to violence in video games	neg
Video games are protected speech under the First Amendment	pos
There is a connection between video games and violence	neg
content-based regulations are presumptively invalid	neg
No evidence links video games to youth violence	pos
There is no compelling link between violent video games and its effects on children	pos
content-based restrictions on games are unconstitutional	neg
states should have the “right to regulate the sale of video games [that are violent] in order to protect minors	pos
violent games cause youth violence	neg
A high degree of relationship between violent games and youth violence has been indicated	neg
video game violence leads to youth violence	neg
Video game content is a form of freedom of expression	pos
there is social utility in expressive and imaginative forms of entertainment, even if they contain violence	pos
There are tangible benefits to violence in games	pos
The policy is controversial both within and outside China because of the manner in which the policy has been implemented, and because of concerns about negative social consequences	neg
The policy is a possible cause behind China's gender imbalance	neg
The policy had proved remarkably effective	pos
The policy is considered as a great success in helping to implement China's current economic growth	pos
The reduction in the fertility rate and thus population growth has reduced the severity of problems that come with overpopulation	pos
the focus of China on population control helps provide a better health service for women	pos
The individual savings rate has increased since the one-child policy was introduced	pos
less intrusive options, including those that emphasized delay and spacing of births, could have achieved the same results over an extended period of time	pos
T]he policy itself is probably only partially responsible for the reduction in the total fertility rate	neg
China could have expected a continued reduction in its fertility rate just from continued economic development, had it kept to the previous policy	pos
The one-child policy is challenged in principle and in practice for violating a human right to determine the size of one's own family	neg
The policy leaves the older generations with increased chances of dependency on retirement funds or charity in order to receive support	neg
Some parents may over-indulge their only child	neg
The one child policy creates social problems and personality disorders in young people	neg
The one-child limit is too extreme. It violates nature’s law	neg
The social pressure exerted by the one-child policy has affected the rate at which parents abandon undesirable children	neg
China's family planning programs contribute to infanticide	neg
a single child would be left with having to provide support for his or her two parents and four grandparents	neg
Coercive sterilization to enforce the one child policy has occurred in China	neg
As a result of the one child policy, China successfully achieved its goal of a more stable and much-reduced fertility rate	pos
Rapid population growth is seen as an obstacle to development	neg
Population control is necessary for economic growth and improved living standards	pos
Coercive measures were used to achieve the desired results of the one-child policy	neg
Rapid fertility reduction associated with the one-child policy has potentially negative results	neg
a decrease in the human population would prevent a significant amount of man-made human suffering	pos
A continuation of the rapid population growth that had been occurring would hinder China's development as a nation	neg
the policy has created abuse for women in China	neg
implementation of the policy has involved forced abortions and forced sterilization	neg
China's gender imbalance is further increased by the One Child Policy	neg
China's birth control policy contributes to forced abortions	neg
China's birth control policy is thought to have been a significant contribution to the gender imbalance in mainland China	neg
the one-child policy is not effective enough to justify its costs	neg
the dramatic decrease in Chinese fertility started before the program began in 1979 for unrelated factors	neg
Population control involve measures that improve people's lives	pos
A large increase in population brings certain poverty on the citizenry	neg
Excessive population growth may reduce output per worker	neg
A larger population means more production	pos
overpopulation has been blamed for a variety of issues, including increasing poverty	neg
reduction of the population is a key to economic growth	pos
economists doubt that a correlation between population reduction and economic growth exists	neg
poverty and famine are caused by bad government and bad economic policies, not by overpopulation	pos
higher population density leads to more specialization and technological innovation, which in turn leads to a higher standard of living	pos
there is no correlation between population density and poverty and starvation	pos
There are a number of problems associated with overpopulation	neg
The success of the policy has been questioned, and reduction in fertility has also been attributed to the modernization of China	neg
The policy is controversial both within and outside of China	neg
Parents have a basic human right to determine freely and responsibly the number and the spacing of their children	pos
Parents have a basic right to decide freely and responsibly on the number and spacing of their children	pos
Parents have the exclusive right to determine freely and responsibly the number and spacing of their children	pos
governments have a responsibility to meet individuals' reproductive needs	pos
The human rights of women include their right to have control over and decide freely and responsibly on matters related to their sexuality	pos
Programs that do not take the interests of women into account are unlikely to succeed	neg
The policies' narrow focus leads to coercion and decreased quality of care	neg
this four-two-one reconfiguration of the familial structure has distinct ramifications for Chinese society	neg
only children are spoiled	neg
only children have aversive social skills	neg
Lack of siblings has been blamed for a number of social ills	neg
The one child policy has been speculated to be the underlying cause of forced abortions	neg
it is more difficult for only children to cooperate in a conventional family environment	neg
only children are higher in achievement motivation	pos
children with many siblings receive fewer resources	neg
Only children are more likely to make outside friends	pos
rapid population growth damages the Earth's resources and diminishes human well-being	neg
Overpopulation is seen as a serious threat to the quality of human life	neg
The use of drugs to enhance performance is considered unethical by most international sports organizations	neg
The use of performance-enhancing drugs is little different from the use of new materials in the construction of suits and sporting equipment, which similarly aid performance and can give competitors an unfair advantage over others	pos
The use of anabolic steroids is now banned by all major sporting bodies	neg
drug testing can be wildly inconsistent and, in some instances, has gone unenforced	neg
There is little danger from anabolica, when the athletes are kept on strictly monitored programmes	pos
The extremely dangerous side-effects of performance-enhancing drugs are admitted	neg
Often, doping was carried out without the knowledge of the athletes, some of them as young as ten years of age	neg
around 10,000 former athletes bear the physical and mental scars of years of drug abuse	neg
the pursuit of doping athletes has turned into a modern day witch-hunt	neg
Many sports organizations have banned the use of performance enhancing drugs and have very strict rules and consequences for people who are caught using them	neg
as outright prevention of doping is an impossibility, all doping should be legalised	pos
There are harmful long-term effects of many doping agents	neg
with doping legal, all competitive athletes would be compelled to use drugs, and the net effect would be a level playing field but with widespread health consequences	neg
doping could be legalized to some extent using a drug whitelist and medical counseling, such that medical safety is ensured, with all usage published	pos
Substance abuse can be harmful to your health and may even be deadly in certain scenarios	neg
"The use of performance-enhancing substances by players is illegal and ethically ""wrong"	neg
There is a wide range of health concerns for users of anabolic steroids	neg
Many former athletes suffer from health problems related to steroid consumption	neg
The extremely dangerous side-effects from anabolica are admitted	neg
former athletes bear the physical and mental scars of years of drug abuse	neg
Health risks can be produced by long-term use or excessive doses of anabolic steroids	neg
Frequent and regular physical exercise boosts the immune system	pos
Physical exercise helps prevent the diseases of affluence	pos
Physical exercise improves mental health	pos
physical exercise may help decrease some of the effects of childhood and adult obesity	pos
Physical exercise is important for maintaining physical fitness	pos
Physical exercise can contribute positively to maintaining a healthy weight	pos
Physical exercise can strenghten the immune system	pos
Frequent and regular aerobic exercise has been shown to help prevent or treat serious and life-threatening chronic conditions	pos
moderate exercise has a beneficial effect on the human immune system	pos
Exercise alone is a potential prevention method and/or treatment for mild forms of depression	pos
Too much exercise can be harmful	neg
Inappropriate exercise can do more harm than good	neg
Introducing students to activities like bowling, walking/hiking, or Frisbee at an early age can help students develop good activity habits that will carry over into adulthood	pos
Teaching non-traditional sports to students may provide the necessary motivation for students to increase their activity, and can help students learn about different cultures	pos
children who fail to engage in regular physical activity are at greater risk of obesity	neg
people can improve their health via exercise	pos
P.E. actually increases test scores	pos
youth do not get the physical outlet needed not only for their cognitive development but for their physical health	pos
Excess weight has reached epidemic proportions globally	neg
Physical fitness can prevent or treat many chronic health conditions	pos
To stay healthy it is important to engage in physical activity	pos
a lack of physical activity is thought to explain most cases of obesity	neg
A sedentary lifestyle plays a significant role in obesity [REF	neg
people die as a result of physical inactivity	neg
Inactivity is one of the leading preventable causes of death worldwide	neg
children learn best with freedom from coercion	pos
There are many health related benefits to being physically active	pos
Affirmative action counters the effects of a history of discrimination	pos
Affirmative action is intended to promote equal opportunity	pos
Affirmative action is intended to ensure that minority groups within a society are included in all programs	pos
Affirmative action helps to compensate for past discrimination, persecution or exploitation by the ruling class of a culture	pos
the principle of equality sometimes requires States parties to take affirmative action in order to diminish or eliminate conditions which cause or help to perpetuate discrimination prohibited by the Covenant	pos
In some countries which have laws on racial equality, affirmative action is rendered illegal because it does not treat all races equally	neg
Affirmative action laws cause disproportionally high costs for small companies and reduce economic growth and employment	neg
it is impossible to favor somebody without discriminating against others	neg
affirmative action devalues the accomplishments of people who are chosen based on the social group to which they belong rather than their qualifications	neg
affirmative action devalues the accomplishments of all those who belong to groups it is intended to help, therefore making affirmative action counterproductive	neg
"affirmative action is ""reverse discrimination"	neg
affirmative action has undesirable side-effects in addition to failing to achieve its goals	neg
Affirmative action may increase racial tension and benefit the more privileged people within minority groups at the expense of the least fortunate within majority groups	neg
affirmative action policies encourage non-preferred groups to designate themselves as members of preferred groups	neg
Affirmative action policies tend to benefit primarily the most fortunate among the preferred group	neg
Affirmative action policies increase animosity toward preferred groups	neg
affirmative action hurts its intended beneficiaries	neg
Merit should be a primary consideration during evaluation	pos
You can't legislate morality	neg
attempts at antidiscrimination have been criticized as reverse discrimination	neg
Affirmative action discriminates against members of a dominant or majority group	neg
each individual's civil rights include the right to be free from government sponsored social discrimination	neg
States must take measures to seek to eliminate prejudices	pos
Historical racism continues to be reflected in socio-economic inequality	neg
Policies adopted as affirmative action have been criticized as a form of referse discrimination	neg
Motivation for affirmative action policies is to redress the effects of past discrimination	pos
Affirmative action policies demonstrate an overt preference for applicants from particular backgrounds over better-qualified (or equally-qualified) candidates from other backgrounds	neg
the only consideration in choosing between applicants should be merit	pos
Affirmative action perpetuates racial division	neg
Differential treatment of racial groups is intended to ameliorate past discrimination	pos
recognition and rights accorded to specific groups may interfere with the state's need to establish a cohesive identity	neg
Affirmative action policies may be considered necessary because the minority group in question is socially disadvantaged	pos
affirmative action is racial division, not racial reconciliation	neg
Affirmative action policies redress imbalances and promote equality	pos
Affirmative action policies for specific racial groups guarantee the full and equal enjoyment of human rights and fundamental freedoms	pos
Discrimination is inherent in affirmative action programs	neg
identical treatment may sometimes act to preserve inequality rather than eliminate it	neg
jobs should go to those “most qualified	pos
The selection process should not be based on some arbitrary or irrelevant criterion	neg
race and sex shouldn't matter when getting a job	neg
final selection for posts must be made according to the principle the best person for the job	pos
The overall idea of affirmitive action is to give children from less fortunate backgrounds more of a chance	pos
The idea of affirmative action is to help disadvantaged groups get back to a normal starting position after a long period of discrimination	pos
any equalities achieved will entail future inequalities	neg
The impetus towards affirmative action is to redress the disadvantages[REF][REF][REF][REF][REF] associated with overt historical discrimination	pos
Policies adopted as affirmative action have been criticised as a form of reverse discrimination	neg
Affirmative action aims to correct the effects of past and present discrimination	pos
no one has a legal right to have any demographic characteristic they possess be considered a favorable point on their behalf	neg
Race-conscious affirmative action remains necessary to address race-based obstacles	pos
Affirmative action is often contested on constitutional grounds	neg
affirmative action requires the very discrimination it is seeking to eliminate	neg
Affirmative action is counter-productive	neg
affirmative action lowers the bar	neg
affirmative action has undesirable side-effects	neg
Affirmative action fails to achieve its goals	neg
Affirmative action hinders reconciliation	neg
Affirmative action replaces old wrongs with new wrongs	neg
Affirmative action undermines the achievements of minorities	neg
Affirmative action encourages groups to identify themselves as disadvantaged, even if they are not	neg
Affirmative action may increase racial tension	neg
affirmative action devalues the accomplishments of people who belong to a group it's supposed to help	neg
Affirmative action creates a cult of victimization	neg
Affirmative action policies reduce the incentives of both the preferred and non-preferred to perform at their best	neg
Affirmative action policies engender animosity toward preferred groups	neg
Affirmative action violates the principle of equal treatment just as much as negative discrimination	neg
one group is favored at the expense of another whenever a quota is invoked	neg
using quotas displaces individuals that would normally be favored based on their individual achievements	neg
qualifications should be the only determining factor	pos
Types of affirmative action that give preference to individuals solely based on their race or gender should not be permitted	neg
"social inequality today is due to ""cultural deficits"" of individual people or racial or ethnic groups"	neg
"there is no need to pay ""systematic attention"" to any current inequities"	neg
Affirmative action programs have at best a negligible impact on the groups they are intended to assist	neg
Preference policies reduce the incentives of both the preferred and non-preferred to perform at their best	neg
Direct intervention in the distribution of assets and opportunities is needed to resolve the economic disparities	pos
Affirmative action is designed to improve the well being of perceived backward and under represented communities	pos
The identification of oppressed classes is difficult to carry out	neg
Knocking a person unconscious or even causing concussion may cause permanent brain damage	neg
There is no clear division between the force required to knock a person out and the force likely to kill a person	neg
amateur boxers, professional boxers and Toughman fighters have died as the result of ring or training injuries	neg
Boxing is an obscenity that should not be sanctioned by any civilized society	neg
Medical Associations have called for bans on boxing	neg
boxing is the only sport where hurting the other athlete is the goal	neg
Boxing is the only sport where the intention is to inflict serious injury on your opponent	neg
Amateur boxers face a high risk of brain damage	neg
The typical knock out results in a sustained loss of consciousness	neg
Repeated blows to the head are known to gradually cause permanent brain damage	neg
In severe cases boxing may cause strokes or paralysis	neg
many physicians advise against sports involving knockouts	neg
fatalities are rare in heavyweight matches	pos
boxing remains the 8th most deadly sport	neg
Sports related to combat skills have been a part of human culture for thousands of years	pos
Contact sports have a higher risk of transmission of blood-borne disease between players	neg
full-contact sports are barbaric	neg
Full contact sports tend to cause injuries	neg
boxing may cause DP	neg
Boxing is very brutal	neg
a powerpunch can do a lot of damage to a boxer	neg
Diversity must be prevalent and valued	pos
differences are recognized as a uniting component rather than a separating one	pos
A multicultural society can never be strong	neg
many multicultural societies have failed	neg
Multiculturalism is a perilous concept on which to found policy	neg
Multiculturalism results in political corruption	neg
Multiculturalism creates friction within society	neg
"the diversity of cultural expressions is a ""rich asset for individuals and societies"	pos
promotion and maintenance of cultural diversity are an essential requirement for sustainable development	pos
diversity brings progress and social cohesion	pos
cultural diversity is as necessary for humankind as biodiversity is for the nature	pos
Cultural diversity is the common heritage of humanity	pos
cultural diversity may be vital for the long-term survival of humanity	pos
cultural diversity is as necessary for humankind as biodiversity is for nature	pos
It is unethical to conserve less developed societies	neg
it is in the best interests of individuals and of humanity as a whole that all people adhere to a specific model for society	pos
Multiculturalism can become a polite and euphemistic way of affirming and persisting unequal power relationships	neg
Multiculturalism tends to emphasize the rights of ethnic minorities at the expense of the majority	neg
The idea of multiculturalism had reached the end of its useful life	neg
cultural differences within society are valuable and should be preserved	pos
one does not need to assimilate or abandon one's heritage in order to blend in	neg
assimilation can hurt minority cultures by stripping away their distinctive features	neg
"separating citizens by ethnicity or race and providing immigrant groups ""special privileges"" can harm the very groups they are intended to help"	neg
the multiculturalist policy of freer immigration is unworkable in an era in which the supply of immigrants from third world countries seems limitless	neg
There is no rational ground for curtailing cultural freedoms	neg
multinationality in a single state should necessarily comprise the right to express and exercise national identity even by minorities	pos
Peoples have the right to the dignity and diversity of their cultures	pos
the distinctiveness of people's identity and their rights to preserve their heritage should be acknowledged	pos
Multicultural classrooms promote decision-making and critical thinking	pos
multiculturalism is a tool for instilling students with pride and confidence in their unique and special backgrounds	pos
Multicultural education provides a relatively fairer learning environment for international students	pos
multicultural education may cause abandonment of original cultural	neg
Diversity is intrinsically valuable to the dominant culture	pos
A homogeneous community grounded on consensus may be unable to criticize the injustice and exclusionary practices that undermine it	neg
Reform of cultural pathology often comes from the recognition of difference	pos
Multiculturalism is a developmental journey through which an individual enhances knowledge and skills about different cultures	pos
Multicultural education in public schools would promote acceptance of diversity	pos
Citizens in a diverse democratic society should be able to maintain attachments to their cultural communities	pos
Unity without diversity results in cultural repression	neg
the strongest nations are those that are made up of different racial elements	pos
multiculturalism helps in bringing together immigrants and minorities in the country	pos
official multiculturalism limits the freedom of minority members	neg
multiculturalism works better in theory than in practice	neg
Multiculturalism perpetuates conflicts between and within groups	neg
Multiculturalism hinders equity and equality in society	neg
diversity is valuable in itself, to preserve human historical heritage and knowledge	pos
Diversity makes available more ways of solving problems and responding to catastrophes	pos
The greater public good warrants eliminating those cultural characteristics that promote conflict or prevent harmony	neg
A community of separate cultures fosters a rights mentality, rather than a responsibilities mentality	neg
A community of separate cultures is divisive	neg
A community of separate cultures works against quick and effective integration	neg
multiculturalism obscures the social costs associated with large scale immigration	neg
Multiculturalism is divisive	neg
Multiculturalism threatens social cohesion	neg
Multiculturalism undermines national unity	neg
some forms of multiculturalism can divide people	neg
Multiculturalism is considered to be dangerous to the West	neg
all cultures and civilizations are of equal value	pos
All cultures and civilizations should be treated and promoted equally	pos
people have the right to maintain an affiliation with one's ethnic group	pos
the community is enriched as difference accrues	pos
multiculturalism has shifted from tolerating multiple cultures to tolerating multiple value systems, which can be hostile to liberalism	neg
Multiculturalism would lead to acceptance of barbaric practices	neg
homogeneity and integration are necessary for a society	pos
Multiculturalism and immigration lead to adaptation problems	neg
Lack of integration threatens society	neg
A liberal democracy cannot be multicultural	neg
Democracy and the rule of law can only be restored by abolishing multiculturalism	neg
The emphasis on group identity and group rights diminishes individual liberty for those within the minorities	neg
state multiculturalism has failed	neg
Unity is seen as an essential feature of the nation and the nation-state	pos
Multiculturalism allows people to truly express who they are within a society	pos
Multiculturalism promotes respect for the dignity of the lives and voices of the forgotten	pos
multiculturalism tries to restore a sense of wholeness in a postmodern era that fragments human life and thought	pos
Multiculturalism ultimately erodes the host nations' distinct culture	neg
the more racially diverse a community is, the greater the loss of trust	neg
recognition and rights accorded to specific groups may interfere with the state's need to establish a cohesive identity	neg
where members of minorities see that their specific needs and ambitions have been acknowledged and catered for, they will commit themselves more willingly to accepting the legitimacy of the nation	pos
the political function of rights is precisely to protect minorities from oppression by majorities	pos
cultural appreciation of ethnic and religious diversity promotes a greater willingness to tolerate political differences	pos
Gambling is a major international commercial activity	pos
Catholic and Jewish traditions have even set aside days for gambling	pos
religious authorities generally disapprove of gambling	neg
there is no moral impediment to gambling	pos
most legal jurisdictions limit gambling	neg
Many jurisdictions, local as well as national, either ban gambling or heavily control it by licensing	neg
regulation generally leads to gambling tourism and illegal gambling	neg
legal gambling provides significant government revenue	pos
Betting on team sports has become an important service industry in many countries	pos
many people participate in gambling as a form of recreation or even as a means to gain an income	pos
gambling, like any behavior which involves variation in brain chemistry, can become a psychologically addictive and harmful behavior	neg
gamblers persist in gambling even after repeated losses	neg
the social and economic consequences of casino gambling outweigh the initial revenue that may be generated	neg
gambling in some form or another has been seen in almost every society in history	pos
Most games played in the casino have mathematically-determined odds that ensure the house has at all times an advantage over the players	neg
Slot machine is addictive	neg
Given the large amounts of currency handled within a casino, both patrons and staff may be tempted to cheat and steal	neg
One area of controversy surrounding casinos is their relationship to crime rates	neg
There is a positive relationship between casinos and crime	neg
In charity gambling profits from the venture go to the charity or group of charities, rather than to a municipality or private casino	pos
problem gambling has been shown to cause dysfunctional families	neg
As a result of gambling, some are driven to extreme lengths to cover debt	neg
addicted gamblers spend most of their energy following their addiction	neg
Addicted gamblers cost companies loss of productivity and profit	neg
Gamblers may suffer from depression and bankruptcy	neg
The social costs of gambling to society are varied	neg
Gambling provides jobs	pos
gambling increases aggregate demand for goods and services in the economy	pos
Money from gambling goes directly towards stimulating the economy	pos
it is economically beneficial for a state to allow and support gambling institutions	pos
Pathological gambling is a common disorder that is associated with social costs	neg
Problem gambling leads to adverse consequences for the gambler, others, or for the community	neg
pathological gambling is an addiction similar to chemical addiction	neg
Problem gamblers have the erroneous belief that if they keep playing, they will eventually win	neg
Pathological gambling is similar to many other impulse control disorders	neg
As debts build up people turn to other sources of money such as theft	neg
Compulsive gambling is often very detrimental to personal relationships	neg
Abuse is common in homes where pathological gambling is present	neg
Problem gambling is often associated with increased suicidal ideation	neg
problem gambling increases the lifetime risk of suicide	neg
Internet gambling is a growing problem for banks and credit card companies	neg
Regulation of online gambling is a better alternative than the prohibition of internet gambling	pos
Internet gambling is a legitimate activity that citizens have the right to engage in	pos
Internet gambling has become one of the most popular and lucrative business present on the Internet	pos
Gambling is now a diverse, vibrant and innovative industry	pos
Gambling is a popular leisure activity enjoyed in many forms by millions of people	pos
Various forms of online gambling are legal and regulated in many countries	pos
the high-speed instant gratification of Internet games and the high level of privacy they offer may exacerbate problem and pathological gambling	neg
electronic funds transfers inherent in online gambling are being exploited by criminal interests	neg
The lotteries proved very popular and were hailed as a painless form of taxation	pos
There can be some problems associated with winning a lottery jackpot	neg
Winners sometimes feel anomie from the dramatic change of lifestyles	neg
lotteries facilitate a higher degree of inequality than a society should have	neg
any social system that allocates resources based on chance is one that is corrupt	neg
Any form of gambling is susceptible to fraud	neg
Gambling leads to increased political corruption, compulsive gambling and higher crime rates	neg
gambling is a type of regressive tax on the individuals	neg
nearly all the western states' governments outlawed gambling	neg
the majority of the states run some type of lottery to raise funds for state operations	pos
immigrants have high rates of criminality	neg
immigrants are thought to compete with employees who are already in the country	neg
immigration threatens national identity	neg
freedom of movement is often recognized as a civil right	pos
everyone has the right to leave or enter a country, along with movement within it	pos
everyone has the right to leave any country, including his own, and to return to his country	pos
the freedom of movement both within and between countries is a basic human right	pos
everyone has the right to seek and to enjoy in other countries asylum from persecution	pos
Political refugees may be fleeing for their lives	pos
prohibition of forcible return is part of customary international law	pos
In some of the illegal immigrants' countries of origin humanitarian hardship exists	neg
Illegal immigrants may serve as informants or as operatives of hostile states or terrorist organizations	neg
Immigrants are contributing to the congestion in the cities and to the rise in crime	neg
failing to stop the illegal immigration waves at an early stage will only lead to much larger waves of illegal immigration in the future	neg
refugees (legally defined to be people who are persecuted in their original country and then enter another country seeking safety) should be exempted from immigration laws	pos
repression and intolerance against immigrants will not solve the problems caused by the economic crisis	neg
countries must be prepared to allow Open borders for people fleeing conflict	pos
refugees have much to bring to the countries in which they are resettled in terms of culture and labor	pos
Frequently, countries of asylum are some of the world?s poorest nations and cannot handle the large influx of persons	neg
Refugee populations consist of people who are terrified and are away from familiar surroundings	pos
Asylum seekers are motivated by the availability of benefits	neg
Migration provides a positive resource for the economy	pos
the opposition to high levels of immigration by refugees is based on racism	neg
Immigrants are considered hostile or alien to the natural culture	neg
the immigrants will distort or spoil existing cultural values	neg
Immigrants acquire jobs which would have otherwise been available to native citizens, suppressing wages	neg
Immigrants damage a sense of community and nationality	neg
Immigrants may overpopulate countries	neg
Immigrants can swamp a native population and replace its culture with their own	neg
"immigrants can ""swamp"" a local population"	neg
everyone can exercise the right to seek asylum and find safe refuge in another state	pos
The system of monarchy since antiquity has contrasted with forms of democracy	neg
The monarch serves as a ceremonial figurehead symbol of national unity and state continuity	pos
a morally-based, balanced monarchy is stressed as the ideal form of government	pos
The hereditary nature of the monarchy is said to conflict with egalitarianism and dislike of inherited privilege	neg
The laws of succession are held by some to be sexist	neg
A monarch serves the traditional role of embodying and representing the nation	pos
Monarchy is a source of checks and balances against elected politicians who might seek powers in excess of those conferred by their respective constitutions	pos
Monarchy is a check against possible illegal action by politicians	pos
the monarch cannot be prosecuted for criminal offences	neg
Social traditions or hierarchies are essential for social order	pos
Monarchs rule with the intent of improving the lives of their subjects	pos
The sovereign knows the interests of his subjects better than they themselves	pos
The monarchy works well	pos
the monarchy is an outdated and regressive institution	neg
Royals are simply celebrities who should not have any formal role	neg
Constitutional monarchy is outdated	neg
republicanism is the next logical step toward a fully democratic constitution	pos
monarchy is unfair and elitist	neg
in a modern and democratic society no one should be expected to defer to another simply because of his birth	neg
Monarchy encourages attitudes which are more suited to a bygone age of imperialism	neg
maintaining a privileged royal family diminishes a society	neg
Monarchy encourages a feeling of dependency in many people who should instead have confidence in themselves and their fellow citizens	neg
Monarchy contradicts democracy	neg
it should be a fundamental right of the people of any nation to elect their head of state and for every citizen to be eligible to hold that office	pos
Monarchical prerogative powers can be used to circumvent normal democratic process with no accountability	neg
Monarchy is ethnic-discrimination	neg
Monarchy is gender-discriminative	neg
A monarchy demands deference	neg
Monarchy is the enemy of merit and aspiration	neg
Monarchy devalues intellect and achievement	neg
Monarchy harms the monarchs themselves	neg
a hereditary system condemns each heir to the throne to an abnormal childhood	neg
Monarchs lack accountability	neg
monarchs are not impartial	neg
monarchs are not accountable	neg
monarchy is expensive	neg
Monarchy is archaic	neg
Monarchy provides a safeguard against government instability	pos
Monarchy safeguards the constitutional rights of the individual	pos
Monarchy provides an impartial arbiter	pos
A monarch can act as an effective intermediary between vaious levels of government and political parties	pos
the Crown is a guarantor against the misuse of constitutional power by politicians	pos
Monarchy provides a focal point for unity and tradition	pos
A constitutional monarch with limited powers and non-partisan nature can provide a focus for national unity	pos
Monarchy provides continuity and stability	pos
Having a long serving monarch increases the sense of duty and continued stability of a nation	pos
monarchy is an impetus for significantly greater national income from tourism	pos
the monarchy is inherently contrary to egalitarianism and multiculturalism	neg
national pride is diminished by the monarchy	neg
monarchies are unfashionable	neg
people are given greater dignity from choosing their head of state	pos
Hereditary succession is outdated	neg
Monarchy is viewed as outdated and irrelevant	neg
The monarchy remains a symbol of imperialism and colonialism	neg
The principal advantage of hereditary monarchy is the immediate continuity of leadership	pos
Monarchy strengthens popular liberty	pos
The monarch is immune from criminal prosecution	neg
"a republic is ""inevitable"	pos
A single election in which the party nominee is selected by nonparty members could be enough to destroy the party	neg
The open primary can be seen as good for voter participation	pos
the open primary allows nonpartisan or independent voters to participate in the nominating process	pos
If nonpartisan or independent voters are allowed to help select the nominees then they may be more likely to vote in the general election	pos
With the open primary more voters become independent and are less likely to participate in the nominating or election processes	neg
the open primary leaves the party nominations vulnerable to manipulation and dilution	neg
Open primary may dilute the vote of a particular party and lead to a nominee who does not represent the views of his particular party	neg
the open primary is unconstitutional	neg
An open primary law is in general unconstitutional	neg
The male condom provides excellent protection against sexually transmitted infections	pos
Barrier contraceptives may increase the risk of pregnancy complications	neg
The use of condoms is encouraged to prevent transmission of HIV	pos
Condoms are widely recommended for the prevention of sexually transmitted diseases	pos
the Catholic Church should actively support condoms used to prevent disease	pos
condom-promotion programs encourage promiscuity	neg
Condoms may interfere with the process of paternal tolerance	neg
Condoms have the  feature of helping to prevent the spread of sexually transmitted diseases	pos
Condoms (male or female) are used to protect against STIs	pos
The best way to prevent being infected or infecting someone with an STI is by using protection during sexual intercourse	pos
Proper use of condoms reduces contact and risk	pos
The majority of HIV infections are acquired through unprotected sexual relations between partners	neg
Catholicism considers all forms of birth control to be sins	neg
Contraception is immoral	neg
Condoms can save life	pos
condoms protect against sexually transmitted diseases	pos
Condoms  prevent sexually transmitted infections	pos
"contraception ""contradicts the will of the Author of life [God"	neg
since artificial contraception expressly prevents the creation of a new life (and, the Church would argue, removes the sovereignty of God over all of Creation), contraception is unacceptable	neg
using condoms during sex is morally contraceptive and thus a sin	neg
Condoms impede the procreative aspect of the sexual act which is understood by the Church to have a deeply theological meaning	neg
permitting condom use as a method of preventing disease could be interpreted as permitting fornication	neg
promotion of condom use will lead to irresponsible, risky sexual behavior	neg
Condoms are a sin in any circumstances	neg
condoms are acceptable as a means of preventing AIDS	pos
condoms should be used to prevent the spread of HIV	pos
Condom use could encourage the spread of HIV by promoting extramarital sex	neg
condom use will prevent the spread of AIDS	pos
"the Church's ban on condoms has ""caused the death of millions"	neg
an act which deliberately attempts to divorce the unitive and procreative meaning of the marital act is opposed to God's plan for life	neg
the Catholic Church should support condoms used to prevent serious diseases such as AIDS, because non-use is tantamount to murder	pos
Birth control could open wide the way for marital infidelity	neg
a man who grows accustomed to the use of contraceptive methods may forget the reverence due to a woman	neg
Contraception is always seriously evil	neg
Contraception is gravely opposed to marital chastity	neg
Contraception is contrary to the good of the transmission of life	neg
Contraception denies the sovereign role of God in the transmission of human life	neg
the Catholic Church should support condoms used to prevent serious diseases such as AIDS	pos
birth control, in all forms, is sin	neg
Persons use condoms to protect against the spread of infections	pos
The problem of AIDS cannot be overcome by the distribution of prophylactics: on the contrary, they increase it	neg
Raising the school leaving age will tackle the problem of young people leaving school unskilled	pos
the history of the drive for compulsory schooling is not guided by altruism, but by a desire to coerce the population into a mold desired by the Establishment	neg
youths should have the right to control and direct their own learning	pos
the current compulsory schooling system violates a basic fundamental right of humans: the right to decide what enters our minds	neg
freedom of learning is part of freedom of thought	pos
forced schooling, regardless of whether the student is learning anything whatsoever, or if the student could more effectively learn elsewhere in different ways, is a gross violation of civil liberties	neg
Schools inhibit a person’s will and ability to self-learn	pos
forced schooling perverts the victims’ natural inclination to grow and learn	neg
high rates of education are essential for countries to be able to achieve high levels of economic growth	pos
release of tactical information usually presents a greater risk of casualties among one's own forces	neg
the right to freedom of speech is not absolute	neg
there must be no constraints on the free flow of information and ideas	pos
democracy will not be true to its essential ideal if those in power are able to manipulate the electorate by withholding information	neg
Access to information is increasingly recognised as a prerequisite for transparency and accountability of governments	pos
access to information is a basic human right	pos
The right of governments to forbid the publication of properly categorized state secrets is recognised	pos
the more freely information flows, the stronger societies become	pos
The individual freedom of expression is essential to the well-being of society	pos
The purpose of classification is to protect information from being used to damage or endanger national security	pos
Everyone has the right to freedom of opinion and expression	pos
Information should be free	pos
leaks .. may have a very negative security impact for people involved	neg
The decision to leak classified information is something that is illegal	neg
free speech is what regulates government and regulates law	pos
The purpose of censorship is to prevent the publication of security information which could benefit the enemy or harm the State	pos
Precisely because the repercussions that decisions of a security nature have on the life of nation, it is suitable to open the door to openly exchanging of views on security issues	pos
Authority to exercise censorship over the press .. is absolutely necessary to the public safety	pos
valuable farmland go to waste for the use of a recreational drug instead of being used to plant food crops	neg
Smoking is considered an immoral habit	neg
Subsidies may distort markets, and can impose large economic costs	neg
subsidies may distort the market and produce inefficiencies	neg
Tobacco use is described as the single most important preventable risk to human health in developed countries	neg
The cultivation of tobacco can be economically detrimental to developing countries	neg
When resources are put into tobacco production they are taken away from food production	neg
Government subsides for tobacco farming do not make economic sense	neg
The cultivation of tobacco is economically detrimental to the countries that produce it	neg
When resources are put into tobacco production, they are taken away from food production	neg
The market system is not adequately rewarding farm people for their agricultural commodities	neg
smoking tobacco is among the leading causes of many diseases	neg
Tobacco-related diseases are some of the biggest killers in the world today	neg
Toxic compounds in tobacco constitute serious health hazards	neg
Subsidies provide little benefit to the farmers themselves	neg
Tobacco is the single greatest cause of preventable death globally	neg
Tobacco use is described as the single most important preventable risk to human health	neg
Tobacco is being considered a usurper of good farm land	neg
Cigarette smoking produces substantial health-related economic costs to society	neg
Tobacco plays an important role in the economy of the producing areas	pos
tobacco causes cancer	neg
commercial tobacco production is a vital part of the American and world economy	pos
smoking-related health problems contribute to rising health care costs	neg
subsidised agriculture in the developed world is one of the greatest obstacles to economic growth in the developing world	neg
artificially low prices resulting from subsidies create unhealthy incentives for consumers	neg
Subsidies are an inefficient use of taxpayer’s money	neg
The free communication of thoughts and of opinions is one of the most precious rights of man	pos
a limitation on freedom of speech prescribed in law can be permitted if it can be justified as being a reasonable limit	pos
Freedom of expression is subject to certain restrictions	neg
Censorship is occasionally carried out to aid authorities or to protect an individual	pos
Freedom of speech may be restricted by law to protect rights and respectability of others	neg
human rights can be limited or even pushed aside during times of national emergency	neg
Government-enforced right of access inescapably dampens the vigor and limits the variety of public debate	neg
Everyone has the right to freedom of opinion and expression	pos
an effort to limit the use of words of language is actually a form of restricting freedom of thought	neg
limitations on free speech balance rights to free speech and other rights	pos
the individual must have unlimited access to the ideas of his fellow men in “a free and open encounter	pos
The individual freedom of expression is essential to the well-being of society	pos
"freedom can be restricted for reasons of ""sovereignty and integrity"	neg
The people should not be deprived or abridged of their right to speak, to write, or to publish their sentiments	pos
when a nation is at war, many things that might be said in time of peace are such a hindrance to its effort that their utterance will not be endured so long as men fight	neg
The right to free speech conflicts with other rights	neg
the freely expressed word can be a direct threat to other human rights	neg
The free communication of ideas and opinions is one of the most precious of the rights of man	pos
The right to freedom of speech and expression may be limited when conflicting with other rights	neg
the expression of dissent or subversive views should be tolerated	pos
"free discussion is necessary to prevent the ""deep slumber of a decided opinion"	pos
Speech can be justifiably suppressed in order to prevent harm from a clear and direct threat	neg
there must be no constraints on the free flow of information and ideas	pos
democracy will not be true to its essential ideal if those in power are able to manipulate the electorate by withholding information and stifling criticism	neg
freedom of speech helps to provide a balance between stability and change	pos
there ought to exist the fullest liberty of professing and discussing, as a matter of ethical conviction, any doctrine, however immoral it may be considered	pos
some forms of expression can be legitimately prohibited by law because they are very offensive	neg
Freedom of speech is a fundamental human right	pos
it is necessary to prevent the use of information resources and technologies for criminal and terrorist purposes	neg
the more freely information flows, the stronger societies become	pos
No human right is more basic than freedom of expression	pos
Clear and present danger is posed by discriminatory speech and the growth of e-hate	neg
Freedom of expression is the lifeblood of any free and open society	pos
liberty of expression 'is not absolute	neg
government may not prohibit the expression of an idea simply because society finds the idea offensive or disagreeable	neg
Punishment of dangerous or offensive writings is necessary for the preservation of peace and good order	pos
Reasonable restrictions upon free speech serve public order	pos
Freedom of speech and of the press lay at the foundation of all democratic organisations	pos
The freedom of speech and of the press does not confer an absolute right to express without any responsibility	neg
All the utterances intended to endanger the security of the State may be restrained in the interest of the security of the State	neg
Freedom of speech and expression can not be an excuse for distribution of indecent and immoral content	neg
Reasonable restrictions on freedom of expression can be imposed in the interest of public order	pos
censorship violates multiple Basic Human Rights	neg
one can not tolerate free speech concerning drugs	neg
Freedom of speech is the heart of democracy	pos
the right to freedom of speech can be subjected to limitations such as hate speech	neg
Without restrictions, total freedom of speech would allow freedom to slander	neg
Press freedom is the right of the people	pos
The American Jobs Act, would give businesses incentives to hire unemployed and disabled veterans	pos
The American Jobs Act gives more tax breaks, thus contributing more to the federal deficit	neg
to improve the economy, policymakers should focus on reforms that remove impediments to work	pos
vouchers and other forms of publicly funded private school choice are necessary to give families an opportunity to enroll their children in more effective private schools	pos
a voucher system for public education would make public schools compete with one another thus making them more accountable and efficient	pos
by distributing vouchers to the families of students equal to the tuition that he/she would receive at his/her local public school, a student’s family could then choose from options where best to send their child	pos
public education would be destroyed by tuition vouchers	neg
the tuition voucher proposal would undermine public education	neg
competition among schools will increase both the quality and the economic efficiency of public education	pos
Vouchers function to increase racial and economic discrimination in schools	neg
since approximately four out of five US private schools are religious, voucher and charter systems violate the Constitution	neg
"a ""competitive education market"" would lead to ""innovation and improvement"	pos
allowing families the option of both public and private schools undermines the public education system	neg
competition would improve schools and cost efficiency	pos
School voucher and education tax credit systems incentivize schools to increase accountability and school performance	pos
the competition spurred by vouchers and education tax credits increases the quality of both eligible private schools and local public schools	pos
Both private and public schools are improving through the use of vouchers	pos
vouchers improve academic outcomes at public schools	pos
Vouchers reduce racial segregation	pos
Vouchers deliver better services to special education students	pos
School vouchers would erode educational standards and reduce funding	neg
a voucher system would weaken public schools	neg
granting government money, even indirectly, to private and religious schools will inevitably lead to increased governmental control over non-government education	neg
Competition for students (and the education dollars that come with them) creates a catalyst for schools to create innovative programs	pos
School choice programs would allow poor students to opt out of bad schools and acquire a better education	pos
vouchers could result in nothing more than a cash-handout for many middle-class and wealthy families already sending their kids to private schools	neg
Through free competition between vendors for the provision of products and services, prices tend to decrease, and quality tends to increase	pos
with federal school vouchers inevitably come further central government regulation and loss of local control over education	neg
Education vouchers would undermine public schools	neg
Earmarks are Good for American Democracy	pos
Reducing earmarks does not reduce government spending	neg
In an already flawed system, earmarks can at least allow residents of Congressional districts to have a greater role in allocating federal funds	pos
directing money to particular purposes is a core constitutional function of Congress	pos
Congressmen tend to distribute specialized benefits at a great cost and ignore the particular costs the legislation bears upon the taxpayers	neg
Committee members can exploit pork barrel projects for electoral purposes	neg
power of the purse is one of Congress's primary checks on the executive branch	pos
the deployment, and implicit menace of use, of strong weapons is essential to threaten the enemy in order to prevent the use by said-enemy of the same weapons	pos
a nuclear nation might be hijacked by a despot or other person or persons who might use nuclear weapons without sane regard for the consequences	neg
Having more nuclear nuclear-weapon states will reduce security for all	neg
nuclear forces continue to play an essential role in war prevention	pos
reliance on nuclear weapons for deterrence is becoming increasingly hazardous and decreasingly effective	neg
nuclear weapon technology would soon reach the point where it could end human life on Earth	neg
nuclear weapons had become a source of extreme risk	neg
nuclear weapons can induce stability	pos
Nuclear weapons decrease the chances of crisis escalation	pos
controlled nuclear proliferation may be beneficial for inducing stability	pos
Nuclear proliferation increases the chance of inter-state nuclear conflict	neg
Nuclear proliferation increases the chances of nuclear material falling into the hands of non-state groups	neg
new nuclear states will use their acquired nuclear capabilities to deter threats and preserve peace	pos
new nuclear states often lack adequate organizational controls over their new weapons	neg
Nuclear weapons may lessen a state's reliance on allies for security, thus preventing allies from dragging each other into wars	pos
nuclear weapons induce stability in all regimes	pos
nuclear weapons contribute to stability at a strategic level	pos
public opinion is overwhelmingly opposed to nuclearization	neg
"the present situation whereby Nuclear Weapon States monopolise the right to possess nuclear weapons is ""highly discriminatory"	neg
more countries with nuclear weapons may increase the possibility of nuclear warfare	neg
The spread of nuclear weapons can increase international stability	pos
Nuclear proliferation will decrease the likelihood of war	pos
The effective prohibition on nuclear proliferation has been characterised as a form of technological apartheid	neg
the significance of nuclear weapons is purely to deter war	pos
The use of (or threat of use of) nuclear weapons would generally be contrary to the rules of international law applicable in armed conflict	neg
unlike conventional weapons, nuclear weapons successfully deter all-out war between states	pos
Nuclear disarmament would undermine deterrence	neg
Nuclear disarmament could lead to increased global instability	neg
an inferior nuclear force, by virtue of its extreme destructive power, could deter a more powerful adversary	pos
Nuclear weapons have become a source of extreme risk	neg
nuclear weapons are intended to deter other states from attacking	pos
Nuclear weapons give nations the potential to not only destroy their enemies but humanity itself	neg
Extreme danger is intrinsic to nuclear war and the possession of nuclear weapons	neg
with nuclear weapons more widely available, deterrence is decreasingly effective and increasingly hazardous	neg
if we hope to escape self-destruction, then nuclear weapons should have no place in our collective conscience, and no role in our security	neg
a full-scale nuclear war could potentially bring about the extinction of the human race	neg
the greater the threat of mutual destruction, the safer the world would be	pos
when two countries each have nuclear weapons, the probability of a direct war between them greatly decreases	pos
"collective bargaining is ""in the public interest"	pos
Collective bargaining contributes to the effective conduct of public business	pos
Collective bargaining facilitates and encourages the amicable settlements of disputes between employees and their employers	pos
Unionization frequently produces higher wages at the expense of fewer jobs	neg
unions promote deadweight loss	neg
The effect of union activities to influence pricing is potentially very harmful	neg
unionized workers raise their own wages above their natural rate at the expense of their businesses or other workers	neg
unions never raise productivity to compensate for higher wages	neg
unionized workers will spend their higher wages, driving economic growth and creating new jobs	pos
Unions may serve the practical purpose of leveling the playing-field between workers and powerful oligopolies	pos
there is an inherent right to collective bargaining	pos
unionisation produces higher wages (for the union members) at the expense of fewer jobs	neg
an individual cannot stand alone against the power of the company	neg
The right to collectively bargain is recognized through international human rights conventions	pos
The freedom of association and the effective recognition of the right to collective bargaining are defined as an essential right of workers	pos
Collective bargaining is regarded as a human right	pos
The right to bargain collectively with an employer enhances the human dignity	pos
Collective bargaining is intrinsically valuable as an experience in self-government	pos
Collective bargaining permits workers to achieve a form of workplace democracy	pos
abortion has negative effects on society	neg
the state has an interest in preserving fetal life	pos
Intact dilation and extraction  is never needed to protect the health of a pregnant woman	neg
partial-birth abortion .. is .. unnecessary to preserve the health of the mother	neg
A partial-birth abortion bears no relevance to any measure needed to advance the health of any woman	neg
abortion causes mental health problems	neg
the right of personal privacy includes the abortion decision	pos
there is a fundamental right to privacy encompassing the decision about abortion	pos
abortions should be legal under any circumstances	pos
Unborn children have an inherent right to life	pos
abortion, and especially late-term abortion, is unjust	neg
Critics consider the IDX procedure to be infanticide	neg
abortion should be legal in all circumstances	pos
The government should not interfere with a woman’s ability to have an abortion	pos
The human fetus is a person and therefore has a right to life	pos
legal abortion under medically controlled conditions is preferable to illegal back-alley abortion without proper medical supervision	pos
Certain restrictions on abortion could be used to form a slippery slope against all abortions	neg
women's lives are lost due to unsafe abortions when abortion is illegal	neg
life begins at conception	pos
Abortion, which would involve the deliberate destruction of life, should be rejected	neg
one must abort a fetus if the continuation of pregnancy might imperil the life of the woman	pos
abortion is justifiable if a continuation of pregnancy might cause the woman severe physical or psychological harm	pos
In all circumstances, it should be the woman's decision whether or not to terminate a pregnancy	pos
Abortion is deemed a fundamental right	pos
A state's ban on partial birth abortion is unconstitutional	neg
induced abortion is the deliberate and unjust killing of the embryo in violation of its right to life	neg
the law should not criminalize just exercises of the right to control one’s own body	pos
criminalizing abortion will lead to the deaths of many women through ‘back-alley abortions	neg
the embryo has a right to life	pos
abortion is wrong because it deprives the embryo of a valuable future	neg
deliberate abortions are seriously immoral	neg
the fetus has a right to life	pos
it should be illegal for governments to regulate abortion	neg
"the state has an ""important and legitimate interest in protecting the potentiality of human life"	pos
"while the state has an interest in protecting the fetus ""at some point"", this interest cannot override that of the pregnant woman"	neg
abortion is morally wrong	neg
while the fetus is innocent and biologically human, it is not a person with a right to life	neg
abortion involves unjust discrimination against the unborn	neg
"deliberate abortions are placed in the ""same moral category"" as killing an innocent adult human being"	neg
having an abortion is equivalent to consciously taking the risk of killing another	neg
Abortion is considered to be morally wrong	neg
A state law banning certain forms of abortion is unconstitutional	neg
D&X would be safer and would involve fewer risks for the women	pos
D&X abortions are never medically necessary	neg
working parents wish their children to be supervised	pos
children need the 2–3 months off to relax and also to take a break from other childhood stresses associated with school	pos
Multitrack schedules reportedly bring many benefits to schools that use them	pos
for every three multitrack schools, one less school must be built	pos
students’ attitudes towards school did significantly increase as they spent more time on a year-round schedule	pos
Students who attend year-round school say that their calendar is more balanced than their peers who have a typical school calendar	pos
year-round schools showed a substantial gain in academic achievement for at-risk, low performing students	pos
More frequent, short breaks provide struggling students more time for help	pos
parents are in favor of the year-round schedule	pos
The year round schedule provides more opportunities for family vacations	pos
If schools are open for longer the operating and maintenance costs may increase	neg
Year round schooling may create difficulties for teens to be able to maintain part-time or summer job	neg
Students with attention learning disabilities may experience difficulties with longer school days	neg
Students that attend year round schooling may miss out on experiences	neg
welfare empowers individuals	pos
Welfare breeds dependence on government aid	neg
Welfare only breeds dependence on the government	neg
welfare has demonstrated some proven effects for helping impoverished families	pos
foreign aid is seen to be serving the interests of the donor more than the recipient	neg
Subsidies may distort markets	neg
subsidies may distort the market	neg
Subsidies produce inefficiencies	neg
Subsidies are inefficient	neg
Welfare reduces poverty	pos
Welfare sustains or even creates poverty	neg
poverty decreases after countries adapt welfare programs	pos
welfare creates a dependence	neg
Welfare makes an incentive to not find work	neg
welfare not only increases poverty but also increases other problems	neg
Safety nets redistribute income to the poorest and most vulnerable, with an immediate impact on poverty	pos
Safety nets enable households to make productive investments in their future that they may otherwise miss	pos
CCT Programs have been proved to be very well-targeted and effective	pos
CCT Programs are efficient tools for reducing poverty and inequality	pos
Subsidies guarantee access to essential commodities at prices that consumers can afford	pos
Subsidies tend to be expensive and regressive	neg
Subsidies may distort production incentives	neg
Safety nets  protect households facing hard times from falling into deeper poverty and help them manage risk	pos
Safety nets protect households facing hard times from falling into deeper poverty and help them manage risk	pos
Safety nets can provide households with a cushion to invest resources more efficiently	pos
less stratified economies are more socially just	pos
the rich have an obligation to assist the poor, thus creating a more financially egalitarian society	pos
the rich exploit the poor or otherwise gain unfair benefits, and thus should return some of those benefits	pos
a larger middle class benefits an economy by enabling more people to be consumers	pos
economic inequality contributes to crime	neg
a lower rate of redistribution in a given society increases the inequality found among future incomes	neg
wealth and income inequality are a cause of economic crises	neg
Reducing wealth and income inequalities is one way to prevent or ameliorate economic crises	pos
Governmental redistribution of wealth improves social stability	pos
there is no encouragement of those receiving aid to resume working	neg
redistribution of legitimately obtained property cannot ever be just	neg
redistribution tends to benefit those with political clout to set spending priorities more than those in need	neg
poverty, once started, is likely to continue unless there is outside intervention	pos
the welfare state has produced a generation of dependents who, instead of working, rely solely upon the state for income	neg
Social welfare creates dependence to the state	neg
Higher levels of economic inequality tend to intensify social hierarchies and generally degrade the quality of social relations	neg
Economic inequality is thought to reduce distributive efficiency within society	neg
a society with more equality will have higher aggregate utility	pos
in societies where inequality is lower, population-wide satisfaction and happiness tend to be higher	pos
an increased gap between rich and poor increases the incentives for competition and innovation within an economy	pos
inequality is harmful for economic development	neg
Redistributive policies have an adverse effect on investment and economic growth	neg
economic equality is necessary for political freedom	pos
when there is economic inequality then political inequality is assured	neg
a certain amount of redistribution would be justified	pos
without redistribution, one generation's successful individuals would become the next generation's embedded caste	pos
social justice requires redistribution of high incomes and large concentrations of wealth in a way that spreads it more widely	pos
economic inequality reduces social cohesion and increases social unrest	neg
economic inequality invariably translates to political inequality	neg
The availability of government funds leads to tensions within the community	neg
Because current science can't figure out exactly how life started, it must be God who caused life to start	pos
there are insufficient grounds to assert authoritatively that any supreme being does not exist	neg
acknowledgment of God or the gods is a major factor in motivating people towards moral behavior	pos
Atheism has been criticized as a faith in itself	neg
atheism systematically influences people to do bad things	neg
The existences of a god and of evil are logically incompatible	neg
God cannot exist with, or would want to prevent, all evils	neg
An omniscient, wholly good being would prevent the occurrence of any intense suffering	neg
belief in a higher being is the product of fear	neg
we do not need God to explain things	neg
the most immoral acts in human history were performed by atheists	neg
the human race no longer needs religion	neg
all attempts to reconcile faith with science and reason are consigned to failure	neg
God, the beginning and end of all, can, by the natural light of human reason, be known with certainty from the works of creation	pos
unproven religious propositions deserve as much disbelief as all other unproven propositions	neg
atheists are quick to believe in God in times of crisis	neg
God and other religious beliefs are human inventions	neg
belief in God and religion are social functions, used by those in power to oppress the working class	neg
the idea of God implies the abdication of human reason and justice	neg
The idea of God is the most decisive negation of human liberty	neg
The idea of God necessarily ends in the enslavement of mankind	neg
denying the existence of a god leads to moral relativism, leaving one with no moral or ethical foundation	neg
Denying the existence of a god renders life meaningless and miserable	neg
Religion is viewed as a human invention used to frighten people into following moral order	neg
atheism is a superior basis for ethics	pos
religions provide a net benefit to individuals and society	pos
religions can be harmful	neg
reliance on divine authority lends itself to authoritarianism and dogmatism	neg
God must exist to give force to moral obligations	pos
objective moral truths and the binding nature of obligations suggests a high power to enforce them, regarded as God	pos
only the existence of God as orthodoxly conceived could support the existence of moral order in the world	pos
A natural moral order requires the existence of God as orthodoxly conceived, so god must exist	pos
there is not good argument for God's existence that arises from pure reason alone	neg
all moral thought requires the assumption that God exists	pos
theists are able to offer justification for morality, while atheists are not	pos
the natural is all that exists	pos
the universe can be explained without any reference to the supernatural	neg
God exists and this can be proven	pos
none of the arguments for God's existence are compelling	neg
life and the universe were created by a deity	pos
faith − belief that is not based on evidence − is one of the world's great evils	neg
atheism is evidence of a healthy, independent mind	pos
nature is all there is	pos
everything in the Universe has a purpose, which must have been caused by God	pos
everything in the Universe follows laws, which must have been created by God	pos
arguments for the existence of God show insufficient reason to believe	neg
The universe includes ideas not perceptible to mankind (or not always perceptible), and there must therefore exist an omniscient superobserver	pos
"there was a ""first cause"", or ""prime mover"" who is identified as God"	pos
the universe's order and complexity are best explained by reference to a creator God	pos
certain features of the universe and of living things are the product of an intelligent cause	pos
basic facts, such as humanity's existence, are best explained by the existence of God	pos
ethics, and other serious matters do not make sense in the absence of God	neg
atheistic arguments must ultimately refute themselves if pressed with rigorous consistency	neg
the theism of people throughout most of recorded history and in many different places provides prima facie demonstration of God's existence	pos
when a person's understanding ponders over the existence of God it encounters nothing but contradictions	neg
natural (non-supernatural) theories adequately explain the development of religion and belief in gods	pos
The argument for the existence of god is a logical fallacy	neg
the concept of an omnipotent entity is logically contradictory	neg
things cannot exist without creators	pos
an omnipotent and omniscient being would not have any reason to act in any way, specifically by creating the universe	neg
if, when asked for, there is no visible help from God, there is no reason to believe that there is a God	neg
an unchanging God cannot be the source of an ever changing world	neg
the idea of God is inconceivable and self-contradictory	neg
a perfect God can have no need to create a world	neg
a benevolent deity ought to create only happy creatures, not an imperfect world like the real world	neg
The evidence allegedly proving the existence of God is insufficient	neg
"God's existence ""can be known with certainty from the created world by the natural light of human reason"	pos
God's existence can be demonstrated	pos
all human experience and action (even the condition of unbelief, itself) is a proof for the existence of God	pos
there is insufficient reason to believe that any gods exist	neg
the existence of some or all gods is logically impossible	neg
The combination of attributes which God may be asserted to have are logically contradictory	neg
there are no good reasons and no credible grounds for believing that gods exist	neg
humanity would be better off without religion or belief in God	neg
Faith is divisive and dangerous	neg
atheism is not a recipe for despair but just the opposite	pos
Atheism is life-affirming in a way that religion can never be	pos
religion does more harm than good	neg
all phenomena could be understood as resulting from purely natural causes	pos
religion was born of fear and ignorance	neg
Religions require beliefs that are irrational	neg
religious beliefs and traditions lack scientific or rational foundations	neg
Religions often posit facts that are contradicted by scientific evidence	neg
Religions teachings are outdated in comparison with modern Western morals	neg
Religions have promoted facts and histories that are contradicted by science	neg
theist religions and their holy books are not divinely inspired, but instead are fabrications of non-divine human individuals	neg
there are reasonable arguments supporting the existence of God	pos
religious belief is a delusion	neg
religion is nothing more than a social construct that primitive humans evolved	neg
the need for explaining life and death can be met by science and philosophy	pos
"atheism was responsible for ""some 20th century atrocities"	neg
theistic religions devalue human compassion and morality	neg
religion is a positive civilizing influence on society	pos
the effect of religious belief, is positively harmful	neg
There is evidence for the existence of a God	pos
evolution can explain the apparent design in nature	pos
"Natural selection and similar scientific theories are superior to a ""God hypothesis""—the illusion of intelligent design—in explaining the living world and the cosmos"	pos
evolution by natural selection can explain apparent design in nature	pos
the designer hypothesis immediately raises the larger problem of who designed the designer	neg
the theory of a universe without a God is preferable to the theory of a universe with a God	pos
religion is needed to make us behave morally	pos
Religion fills a much needed gap	pos
religion is socially dangerous	neg
The God hypothesis is considered inferior to evolution by natural selection as explanations for the complexity of life	neg
where design fails to explain complexity, evolution by natural selection succeeds	pos
The theory of natural selection is much simpler than the theory of the existence of such a complex being, and thus preferable	pos
God is improbable	neg
a creator of a universe with such complexity would have to be complex and improbable	neg
there must be a first cause, which can be given the name God	pos
something caused the Universe to exist, and this First Cause must be God	pos
existence must be due to an agent cause	pos
the existence of the Universe requires an explanation, and the creation of the Universe by a First Cause, generally assumed to be God, is that explanation	pos
a god created the Universe	pos
Normal aging is associated with a decline in various memory abilities in many cognitive tasks	neg
separation of older people from active roles in society is normal and appropriate	pos
Separation of older people from active roles in society benefits both society and older individuals	pos
the more active elderly people are, the more likely they are to be satisfied with life	pos
older workers are more expensive than younger ones	neg
Older workers lack up-to-date skills	neg
Older people are seen as a group that acts as more of a cost than an asset to the company	neg
The older generation workers often require more benefits from the company due to their age	neg
the age at which retirement is mandated is often somewhat arbitrary and not based upon an actual physical evaluation of an individual person	neg
The practice is viewed as a form of age discrimination, or ageism	neg
it is unlawful to discriminate against a person because of his/her age	neg
Identification requirements may heighten the opportunities for confusion and voter intimidation	neg
Identification requirements may reduce rather than expand the electorate	neg
Voter identification laws could suppress the turnout by voters	neg
Presenting photographic IDs is a minor inconvenience when weighed against the possibility of ineligible voters affecting elections	pos
photo ID requirements disproportionately affect minority and elderly voters	neg
Photo identification is necessary to prevent widespread voter fraud	pos
Photo identification would decrease voting	neg
The danger of voter fraud threatens the integrity of the entire electoral process	neg
Legislation to impose restrictive photo ID requirements has the potential to block millions of eligible American voters, and thus suppress the right to vote	neg
Procedures for acquiring an ID are too burdensome and costly for some low income or elderly voters	neg
military service provides job skills	pos
personal and technical skills learned in the military will improve later employment prospects in civilian life	pos
leadership skills acquired during military training can absolutely enhance one’s chances for success in corporate life	pos
in the case of a mandatory draft members of the U.S. Congress would be much less likely to authorize an unnecessary war	pos
bringing back the draft would remedy the social disparity	pos
a draft would make the military more representative of the American public at large	pos